NO                  textures/ccc/bbb.xpm
SO textures/ccc/bbb.xpm
WE textures/ccc/bbb.xpm
EA textures/ccc/bbb.xpm

F 164,169,20
C 153,204,255

    11111111111111111111111101
11110000000000000000000000000011
100000000000000N0000000000000000001
11000000000000000000000000000000000001
 1000000000000000000000000000000000000001
  111111111000000011111111111111
100000000000000000000000000000001  
 1111111111111111111111111111111