NO                  textures/ccc/bbb.xpm
SO textures/ccc/bbb.xpm
WE textures/ccc/bbb.xpm
EA textures/ccc/bbb.xpm

F 164,169,20
C 153,204,255

111111111
110N00001111
10000000011111111111111
10000000000000000000001
10000000000000000000000
100000000000000000000001111111
100000000000000000000000000011
11111111111111111111111111111111