NO                  textures/ccc/bbb.xpm
SO textures/ccc/bbb.xpm
WE textures/ccc/bbb.xpm
EA textures/ccc/bbb.xpm

F 164,169,20
C 153,204,255

1111111111111111111111111111111111
100000000000000000000000000N0001111111111
1000000000000111000000000000001
10000000000001 10000000010000001111111111
10000000000001 10000000000000000000000001
11111111111111 11111111111111111111111111
