NO                  textures/ccc/bbb.xpm
SO textures/ccc/bbb.xpm
WE textures/ccc/bbb.xpm
EA textures/ccc/bbb.xpm

F 164,169,20
C 153,204,255

1111111111111111111111111111
10000000000000000000000000001111
100000000000000000000000000000001
10000S000111000000000000000000001
1000000001 10000000000000000000001
1000000001 1000000000000000001111
1111111111 111111111111111111