NO textures/wall.xpm
SO textures/wall2.xpm
WE textures/wall3.xpm
EA textures/wall4.xpm

F 139,112,7
C 153,204,255

1111111111111111111111111111111111111111
1000000000000000000000000000000000000001
1000111110000000001111110000000011110001
1000100010000000001000010000000010010001
1000100010000000001000010000000010010001
1000111110000000001111110000000011110001
1000000000000000000000000000000000000001
1000000000111111111111111111000000000001
1000000000100000000000000001000000000001
1000000000100000000000000001000000000001
1111110000100001111111100001000011111111
1000000000100001000000100001000000000001
100000000010000100N000100001000000000001
1000000000111111000000111111000000000001
1000000000000000000000000000000000000001
1000001111111111111111111111111100000001
1000001000000000000000000000000100000001
1000001000000000000000000000000100000001
1000001111111111111111111111111100000001
1000000000000000000000000000000000000001
1000000000000000000000000000000000000001
1111111111111111111111111111111111111111