NO ./north.xpm
SO ./south.xpm
WE ./west.xpm
EA ./east.xpm

F 220, 100, 0
C 225 ,30 ,0


11111
11 11  
11000000001
1 N 1
11111