NO ./north.xpm
SO ./south.xpm
WE ./west.xpm
EA ./east.xpm
F 220,a,0
C 225,30,0

111111
100001
10N001
111111