NO ./north.xpm
SO ./south.xpm
WE ./west.xpm
EA ./east.xpm

F 220, 100, 0
C 225 ,30 ,0

11111
10001
10N01
10001
11111