NO textures/wall.xpm
SO textures/wall2.xpm
WE textures/wall3.xpm
EA textures/wall4.xpm

F 220, 100, 0
C 225 ,30 ,0

111111
10011
10N00111111111
111111