NO ./north.xpm
SO ./south.xpm
WE ./west.xpm
EA ./east.xpm

F 220, 100, 0
C 225 ,30 ,0

111111
1N0101
111 11
111111